Cvičné projekty

MadLips - Script vezme neomezený počet slov ze vstupu a vytvoří náhodné (nebo ne tolik náhodné věty)
Uhádni číslo - Uřivatel skrze konzoli hádá hodnotu náhodného cisla
Textová hra - Popis asi není nutný (tento projekt je velice dobře škálovatelný)
Házení kostkou - Simulace hodu kostkou, nebo více kostkami s možností přehozu jednotlivých kostek
Oběšenec - Hádání písmen ve slovu 
EmailSlicer - program získá ze zadaného emailu doménu a jméno uživatele
Kámen nůžky papír - script který s uživvatelem hraje kámen nůžky papír
Fibonaciho posloupnost - Vytvořit fibonaciho posloupnost
Je čílo prvkem fibonaciho posloupnost - Algoritmus, který zjistí jestli je číslo prvkem posloupnosti
Výpočet faktoriálu - Spočítá faktoriál
Najdi palindromy 

Složitější projekty 
Notifikační program - Script, který se postará o vytvoření upozornění (notify2)       # Jindra
Program pro stahování videií z youtube - Script, který po zadání adresy videa stáhne dané video     # Hrabáček
Website blocker - Script, který zamezí přístupu k některým webovým stránkám          #Balga
Kalkulačka - Grafická kalkulačka pomocí Tkinter (poměrně škálovatelný projekt)        # Maleta
Semináhodný generátor hesel- Tento skript se zeptá na některé osobní údaje a vytvoří zapamatovatelné a silné heslo #Hornof
Náhodný článek z wikipedie - Script, který vybyre náhodný článek z wikipedie v určitém jazyce, a umožní jeho zobrazení    #Schejbal
Stopky, Budík, časovač - Tkinter aplikace schopná stopovat čas, nastavit časovač a budík # Beran
Piškovorky - grafické Tkinter (hráč vs hráč) ; (hodně pokročilá verze napsat AI soupeře)
Stenografie - Skrytá zpráva ukrytá v obrázku # Němec
Převodník měn - který čerpá z aktuálních dat # Bžatek
Sudoku - Generátor (grafický/konzolový)
Sudoku - Řešitel (grafický/konzolový)
Zobrazení souborového stromu - Script zobrazí souborový strom od určitého kořenového adresáře (uživatel může zadat co vynechat a hloubku zobrazení) (konzole)
Test rychlosti psaní - Uživatel dostane test, který má napsat program zpočítá čas za jaký se mu to povedlo.     #Veselák
Sudoku čtečka - přečte informace ze sudoku (OpenCV) Tesseract ocr
Virtuální kreslení - OpenCV Tesseract ocr
Čtení stojově čitelných údajů - čtení údajů nalezených na  cestovním pasu OpenCV Tesseract ocr #Rejl
LPR - Rozpoznání SPZ vozidla a přečtení údajů       # Popelář, Božková, Horký
Zápis do databáze - textový soubor s pevně definovanou strukturou se převede do databáze (PostgreSQL,sqlAlchemy)
Blog - vytvoření webové stránky pomocí Flasku
Virus #Žaludová
Řešitel závislostí - Nainstaluje všechny potřebné moduly a spustí script po ukončení opět vše vrátí do původního stavu
Text editor - Vytvořit komplexní text editor vycházející z Editoru probíraného v rámci výuky
Šifrování a dešifrování - zpráv (spustitelných kódů-pokročilá verze) # Gallus

Pokročilé
Webový vyhledávač - prohledává web ...
Web crawler - Script procházející internet a ukládající zajímavá data       # Staněk
Sledování útrat - Program který sleduje práci s budgetem
Program pro stahování fotek z instagramu
Projekt pro komunikaci s neo4j 
Spam filter (machine learning)
<<<<<<< HEAD

=======
>>>>>>> 31970527e818f3fcb0f4e0cc4da716e3556ab2fc
